                                                  
                                                  
                                                  
                                                  
                                                  
                                                  
                                                  
          ########              #########         
          #      #              #       #         
          #      #              #       #         
          #      #              #       #         
          #      #              #       #         
          #      #              #       #         
          #      #              #       #         
          #      #              #       #         
###       ########              #########      ###
#                                                #
# #                     ###                    # #
#                     ##  ##                     #
# #                  ##     #                  # #
#                    #      ##                   #
# #                 ##       #                 # #
##                  #        #                  ##
                   ##         ##                  
                    #         #                   
                    #         #                   
                    #         #                   
                    #        ##                   
                    #        #                    
                     #       #                    
                     #      #                     
                      #    ##                     
                                                  
                        # #                       
                                                  
                        # #                       
                        # #                       
                 #######  #######                 
                 #  #    #    # #                 
                    # #  # #  #                   
                 #######  #######                 
                         #                        
                 #### ######  ###                 
                                                  
                                                  
                                                  
                                                  
                                                  
                                                  
                                                  
