                                                  
                                                  
                                                  
                                                  
                                                  
                                                  
                                                  
                                                  
                                                  
                     ###  ###                     
                     #      #                     
                     #      #                     
                     #      #                     
                     #      #                     
                     #      #                     
                     #      #                     
          #########  ########  #########          
          #                            #          
          #                            #          
  #### #### ######## ###  ### ######## #### ####  
  #       # #      # #      # #      # #       #  
  #       # #      # #      # #      # #       #  
  #       # #      # #      # #      # #       #  
  #       # #      # #      # #      # #       #  
  #       # #      # #      # #      # #       #  
  #       # #      # #      # #      # #       #  
  #       # #      # #      # #      # #       #  
  #### #### ###  ### ######## ###  ### #### ####  
          #                            #          
          #                            #          
          # ########################## #          
          #                            #          
          #                            #          
          #                            #          
          ####### ######  ###### #######          
             #       #      #       #             
             #       #      #       #             
             #       #      #       #             
             #       #      #       #             
             #       #      #       #             
             #       #      #       #             
             #########      #########             
                                                  
                                                  
                                                  
                                                  
                                                  
                                                  
                                                  
                                                  
