                                                  
                                                  
                                                  
                                                  
                             ###                  
                         #######                  
                       ##########                 
                      #######                     
                ##################                
               ####################               
            #######################               
          ##########################              
         ############################             
         ##############################           
        #############   ########   ####           
        ###########       ###         ##          
      ############     ### ##    ###              
      ###########      ######    ####  ###        
      ###########      #### #    ####  ###        
     ############         # #       #  ###        
     #############         ##         #####       
    ###############       ####        #####       
    #######   #######    ######    #########      
   ######        ######## #  #  ############      
   #####         #######        ############      
   #####         ######          ###   #####      
   #####        ############ ######      ###      
    #####       ############ ######      ###      
    ######     #######          ####    ####      
    ######### ########          ##### #####       
    ########## #########      ###### #####        
     ######### ##########  ######## ######        
      ######### #########  ####### #######        
       ######### ########  ###### ######          
         #######  #######  ##### ######           
          #######                #####            
         ######     ###########  ######           
        ######  ################ #######          
        #####  ################# ########         
       ###### ##################  #######         
       #####  ########   ######## #######         
      ###### ######### ########## ########        
      #####  ####################  #######        
     ###### ###################### #######        
                                                  
                                                  
                                                  
                                                  
                                                  
                                                  
