######################### ########################
#     #       #       #   #     #   #     #   #   
##### # ##### # ### ### ### ### # # ##### # # # # 
#     #   #   # # #   #   # #   # #     #   #   # 
# ####### # ### # ### ### ### ### ##### ####### ##
# #       #   #     #   #   #       # #       #   
# ### ############# # ##### ####### # ####### ### 
#   #           #   #     #   #     #             
### ### ####### # ### ####### # # # ### ##########
# #       #     # #     #     # # #   #     #     
# ### ##### ##### # ##### ##### # ### ### ### ### 
#   # #   # #   # #       #   # #   # # #     # # 
### # # # # ### # ######### # # ### # # ####### # 
#     # # #     # #         # #   # #   #     #   
# # ### # # ##### # ######### ### ####### ### ### 
# #   # # #     # #         # # #     #     #   # 
# ### # # ##### # ##### ### # # ##### ######### ##
#   #   #   # # #     #   # #         #   #   #   
### ####### # # ##### ### # ######### # ### # ### 
# #   #   # #   #     #   #       #   # #   #   # 
# ### # # # ##### # ###  ########## ### # ##### # 
#   # # # #     # # #         #     #   #     #   
### # ### ##### # # #         # ##### # ##### ### 
# # #   #   #     # #         #       #   #   #   
# # # # ### # #######         # ######### # ### ##
#   # #     #       #         # #         #   #   
# ### ############# #         # # ### ####### ### 
#   # #       #     #         # # #   #     # #   
# # # # ##### # #####         # ### ####### # # # 
# #   #     #   #   #         #   #           # # 
##### ##### ####### ##### ##### # ##### ####### ##
#   # #     #     #   #   #   # #     #   #   #   
# # # # ####### # ### # # # # # ##### # # # # ### 
# #   # #     # #   #   #   #       # # # # #     
####### ##### # ### ################# # ### # ####
#   #         # #   # #   #     #   # # #   # #   
# # # ##### ##### # # # # # ##### # ### # ### # ##
# # #   #   # #   # #   # # #   # #     #   #     
# # ### # ### # ######### # # # ########### ##### 
# #   # # # #   #     #   #   # #   #     # #     
# ##### # # # ### ### # # ### # # # # ### # # ####
#       # # #       #   #   # #   #   #   # #     
######### # ####### ####### # ########### ####### 
# #   #   #   #   #     #   # #   #     #   #   # 
# # # # # ### # ####### # ### # # # ### ### # # # 
#   # # #   #         # #   # # # # #       # #   
### # ##### # ####### # ### # # ### ######### ####
#   # #     #   #   # #   # # # #   #   #   #     
# ### # ##### # # # ##### # # # # ### # # # ##### 
#   #         #   #       #     #     #   #       
